{
  
  "layout": [
    "###############",
    "#...SCSCCDD.E.#",
    "#.C....C......#",
    "#.P..A.C......#",
    "#.P....C......#",
    "#.P....C......#",
    "#.G....C......#",
    "#.CTCTCCOOO...#",
    "#.............#",
    "###############"
  ],
  "orders": [
    {
      "ingredients": ["Onion"],
      "instant": 0,
      "duration": 50,
      "score": 10
    }
  ],
  "max_steps": 100
}
